ABCDEFGHO
         
200005890
060090710
900700004
         
000060058
006000400
590030000
         
300008007
049020080
085100009